//MAP CONVERTED BY dmm2tgm.py THIS HEADER COMMENT PREVENTS RECONVERSION, DO NOT REMOVE
"a" = (
/turf/space,
/area/test_area/edge_of_map)
"c" = (
/turf/unsimulated/wall,
/area/test_area/requires_power_non_dynamic_lighting)
"d" = (
/turf/simulated/floor,
/area/test_area/general)
"f" = (
/obj/effect/landmark/test/space_turf,
/turf/space,
/area/test_area/general)
"k" = (
/turf/space,
/area/test_area/general)
"m" = (
/obj/effect/landmark/test/safe_turf,
/turf/simulated/floor,
/area/test_area/general)
"r" = (
/turf/unsimulated/wall,
/area/test_area/powered_non_dynamic_lighting)
"u" = (
/turf/unsimulated/floor{
	icon_state = "hydrofloor"
	},
/area/test_area/powered_dynamic_lighting)
"v" = (
/turf/unsimulated/wall,
/area/test_area/powered_dynamic_lighting)
"z" = (
/turf/unsimulated/wall,
/area/test_area/general)
"A" = (
/turf/unsimulated/floor{
	icon_state = "hydrofloor"
	},
/area/test_area/requires_power_dynamic_lighting)
"E" = (
/turf/unsimulated/wall,
/area/test_area/requires_power_dynamic_lighting)
"P" = (
/turf/unsimulated/floor{
	icon_state = "hydrofloor"
	},
/area/test_area/requires_power_non_dynamic_lighting)
"Z" = (
/turf/unsimulated/floor{
	icon_state = "hydrofloor"
	},
/area/test_area/powered_non_dynamic_lighting)

(1,1,1) = {"
a
a
a
a
a
a
a
a
a
a
a
a
a
a
a
a
a
a
a
a
a
a
a
a
a
a
"}
(2,1,1) = {"
a
a
a
a
a
a
a
a
a
a
a
a
a
a
a
a
a
a
a
a
a
a
a
a
a
a
"}
(3,1,1) = {"
a
a
a
a
a
a
a
a
a
a
a
a
a
a
a
a
a
a
a
a
a
a
a
a
a
a
"}
(4,1,1) = {"
a
a
a
a
a
a
a
a
a
a
a
a
a
a
a
a
a
a
a
a
a
a
a
a
a
a
"}
(5,1,1) = {"
a
a
a
a
a
a
a
a
a
a
a
a
a
a
a
a
a
a
a
a
a
a
a
a
a
a
"}
(6,1,1) = {"
a
a
a
a
a
a
a
a
a
a
a
a
a
a
a
a
a
a
a
a
a
a
a
a
a
a
"}
(7,1,1) = {"
a
a
a
a
a
a
a
a
a
a
a
a
a
a
a
a
a
a
a
a
a
a
a
a
a
a
"}
(8,1,1) = {"
a
a
a
a
a
a
a
z
z
z
z
z
z
v
v
v
r
r
r
a
a
a
a
a
a
a
"}
(9,1,1) = {"
a
a
a
a
a
a
a
z
d
d
d
d
d
v
u
v
r
Z
r
a
a
a
a
a
a
a
"}
(10,1,1) = {"
a
a
a
a
a
a
a
z
d
d
d
d
d
v
u
v
r
Z
r
a
a
a
a
a
a
a
"}
(11,1,1) = {"
a
a
a
a
a
a
a
z
d
d
m
d
d
v
u
v
r
Z
r
a
a
a
a
a
a
a
"}
(12,1,1) = {"
a
a
a
a
a
a
a
z
d
d
d
d
d
v
v
v
r
r
r
a
a
a
a
a
a
a
"}
(13,1,1) = {"
a
a
a
a
a
a
a
z
d
d
d
d
d
v
u
v
r
Z
r
a
a
a
a
a
a
a
"}
(14,1,1) = {"
a
a
a
a
a
a
a
z
z
z
z
z
z
v
v
v
r
r
r
a
a
a
a
a
a
a
"}
(15,1,1) = {"
a
a
a
a
a
a
a
z
z
z
z
z
z
E
E
E
c
c
c
a
a
a
a
a
a
a
"}
(16,1,1) = {"
a
a
a
a
a
a
a
z
k
k
k
k
k
E
A
E
c
P
c
a
a
a
a
a
a
a
"}
(17,1,1) = {"
a
a
a
a
a
a
a
z
k
k
k
k
k
E
A
E
c
P
c
a
a
a
a
a
a
a
"}
(18,1,1) = {"
a
a
a
a
a
a
a
z
k
k
f
k
k
E
A
E
c
P
c
a
a
a
a
a
a
a
"}
(19,1,1) = {"
a
a
a
a
a
a
a
z
k
k
k
k
k
E
E
E
c
c
c
a
a
a
a
a
a
a
"}
(20,1,1) = {"
a
a
a
a
a
a
a
z
k
k
k
k
k
E
A
E
c
P
c
a
a
a
a
a
a
a
"}
(21,1,1) = {"
a
a
a
a
a
a
a
z
z
z
z
z
z
E
E
E
c
c
c
a
a
a
a
a
a
a
"}
(22,1,1) = {"
a
a
a
a
a
a
a
a
a
a
a
a
a
a
a
a
a
a
a
a
a
a
a
a
a
a
"}
(23,1,1) = {"
a
a
a
a
a
a
a
a
a
a
a
a
a
a
a
a
a
a
a
a
a
a
a
a
a
a
"}
(24,1,1) = {"
a
a
a
a
a
a
a
a
a
a
a
a
a
a
a
a
a
a
a
a
a
a
a
a
a
a
"}
(25,1,1) = {"
a
a
a
a
a
a
a
a
a
a
a
a
a
a
a
a
a
a
a
a
a
a
a
a
a
a
"}
(26,1,1) = {"
a
a
a
a
a
a
a
a
a
a
a
a
a
a
a
a
a
a
a
a
a
a
a
a
a
a
"}
(27,1,1) = {"
a
a
a
a
a
a
a
a
a
a
a
a
a
a
a
a
a
a
a
a
a
a
a
a
a
a
"}
(28,1,1) = {"
a
a
a
a
a
a
a
a
a
a
a
a
a
a
a
a
a
a
a
a
a
a
a
a
a
a
"}
